#####################################
#                                   #
#                                   #
#                                   #
#                                   #
#                                   #
#                                   #
#                                   #
#                                   #
#                                   #
#                                   #
#                                   #
#                                   #
#                                   #
#                                   #
#                                   #
#                                   #
#                                   #
#                                   #
#                                   #
#                                   #
#                                   #
#                                   #
#                                   #
#                                   #
#                                   #
#                                   #
#                                   #
#@                                  #
#####################################
