############################################################
#                                                          #
#                                                          #
#                                                          #
#                                                          #
#                                                          #
#                                                          #
#                                                          #
#                                                          #
#                                                          #
#                                                          #
#                                                          #
#                                  #                       #
#                                                          #
#                                                          #
#                                                          #
#                                                          #
#                                                          #
#                                                          #
#                                                          #
#                                                          #
#                                                          #
#                                                          #
#                                                          #
#                                                          #
#                                                          #
#                                                          #
#                                                          #
#@                                                         #
############################################################
